Phew, work is finally over. Being a zookeeper is exausting! As you exit the zoo and approach your car, you realized that something doesn't feel right...your keys aren't in your pockets! You run back into the zoo's main plaza and frantically start looking, when you suddenly realize that those rascal monkeys might have taken it! 
Keys please
Get those monkeys! by Christian Yuh The release number is 1
Release 1 / Serial number 170226 / Inform 7 build 6M62 (I6/v6.33 lib 6/12N) SD

Main Plaza
A beautiful open plaza. The bathroom is to the west and the aquatic center is to the east and the safari zone is to the south.

I beg your pardon?

I beg your pardon?

* * *

>An every turn rule:
That's not a verb I recognise.

>If the lion is wearing the leash;
That's not a verb I recognise.

>s
Safari Zone
A opening with many different animal cages around it. There is a sign in the middle of the opening. The main plaza is to the north and the ape cage is to the south and the lion cage is to the west.

>s
Ape Cage
a cage for the most annoying animals on the planet. You see a little monkey smiling at you, and the Alpha monkey dangling your much needed car keys!

>n
Safari Zone
A opening with many different animal cages around it. There is a sign in the middle of the opening. The main plaza is to the north and the ape cage is to the south and the lion cage is to the west.

>n
Main Plaza
A beautiful open plaza. The bathroom is to the west and the aquatic center is to the east

>w
Bathroom
A quaint little room where people can handle their business. There is a mirror on the wall as well as a cubboard. A trashcan is in the corner. The Main Plaza is to the east

>open trashcan
You open the trashcan, revealing Apple.

>take apple
Taken.

>n
You can't go that way.

>s
You can't go that way.

>e
Main Plaza
A beautiful open plaza. The bathroom is to the west and the aquatic center is to the east

>w
Bathroom
A quaint little room where people can handle their business. There is a mirror on the wall as well as a cubboard. A trashcan is in the corner. The Main Plaza is to the east

>open cubboard
You open the cubboard, revealing a collar.

>take collar
Taken.

>e
Main Plaza
A beautiful open plaza. The bathroom is to the west and the aquatic center is to the east

>s
Safari Zone
A opening with many different animal cages around it. There is a sign in the middle of the opening. The main plaza is to the north and the ape cage is to the south and the lion cage is to the west.

* * *

>s
Ape Cage
a cage for the most annoying animals on the planet. You see a little monkey smiling at you, and the Alpha monkey dangling your much needed car keys!

>give apple to monkey
the monkey looks at the nasty little half eaten apple and starts devouring the little morsel

>take rope
monkey is distracted by his tasty apple and you steal the rope

>combine rope with collar
You combine the rope and collar to make a leash.

>n
Safari Zone
A opening with many different animal cages around it. There is a sign in the middle of the opening. The main plaza is to the north and the ape cage is to the south and the lion cage is to the west.

>w
Lions cage
 The cage for the king of the jungle. You see a scuba tank inside the enclosure.

>w
Pride Rock
The rock where the lions hang out. A big lion is eyeing you 30 ft away.

>take tank
Taken.

>e
Lions cage
The cage for the king of the jungle.

>e
Safari Zone
A opening with many different animal cages around it. There is a sign in the middle of the opening. The main plaza is to the north and the ape cage is to the south and the lion cage is to the west.

>n
Main Plaza
A beautiful open plaza. The bathroom is to the west and the aquatic center is to the east

>e
aquatic center
A center with many different exibits around it. There is a sign in the middle of the opening and a table in the corner. The main plaza is to the west and the dolphin encosure is to the east.

You can see Shark tooth here.

>take shark tooth
Taken.

>e
Dolphin enclosure
You are on the balcony of the dolphin enclosure. the water looks very nice and calm. The aquatic center is to the west and the pool is below

>wear tank
You put on the scuba tank.

>d
you jump into the water.

Pool
the water feels very warm up here, you see some fish down below. The bottom of the pool is below.

>d
Bottom of Pool
 "blub blub" the water is very chilly down here "blub blub" you can see a fish next to "blub blub" a treasure chest.

>open chest with shark tooth
You unlock the treasure chest.

>take meat
You can't see any such thing.

>x chest
a beautiful treasure chest layered in diamond with a tooth shaped lock.

>open treasure chest
You open the treasure chest, revealing Meat.

>take meat
Taken.

>n
You can't go that way.

>u
you jump into the water.

Pool
the water feels very warm up here, you see some fish down below. The bottom of the pool is below.

>u
Dolphin enclosure
You are on the balcony of the dolphin enclosure. the water looks very nice and calm. The aquatic center is to the west and the pool is below

>w
aquatic center
A center with many different exibits around it. There is a sign in the middle of the opening and a table in the corner. The main plaza is to the west and the dolphin encosure is to the east.

>w
Main Plaza
A beautiful open plaza. The bathroom is to the west and the aquatic center is to the east

>d
You can't go that way.

>s
Safari Zone
A opening with many different animal cages around it. There is a sign in the middle of the opening. The main plaza is to the north and the ape cage is to the south and the lion cage is to the west.

>w
Lions cage
 The cage for the king of the jungle. You see a scuba tank inside the enclosure.

* * *

>w
Pride Rock
The rock where the lions hang out. A big lion is eyeing you 30 ft away.

>x lion
The king of the jungle. It is angry and you can't get near him...maybe you can tame him with some food?

>give lion meat
Lion devours the piece of meat and starts cuddling with you.

>put leash on lion
Putting things on Lion would achieve nothing.

>s
You can't go that way.

>e
Lions cage
 The cage for the king of the jungle. You see a scuba tank inside the enclosure.

>s
You can't go that way.

>e
Safari Zone
A opening with many different animal cages around it. There is a sign in the middle of the opening. The main plaza is to the north and the ape cage is to the south and the lion cage is to the west.

>s
Ape Cage
a cage for the most annoying animals on the planet. You see a little monkey smiling at you, and the Alpha monkey dangling your much needed car keys!

>take keys
Alpha monkey bares his teeth and tries to rip your head off. Maybe trying to take them now is not such a good idea...

>take car keys
Alpha monkey bares his teeth and tries to rip your head off. Maybe trying to take them now is not such a good idea...

>take car key
You can't see any such thing.

>x alpha
 a huge monkey that can be mistaken for a gorilla. He has teeth the size of tigers, as much muscle as a horse and claws the size of a pointer finger . Only a king can rival him...

>take car key
You can't see any such thing.

>take house key
Alpha monkey bares his teeth and tries to rip your head off. Maybe trying to take them now is not such a good idea...

>i
You are carrying:
  Shark tooth
  a scuba tank (being worn)
  Leash

>s
You can't go that way.

>n
Safari Zone
A opening with many different animal cages around it. There is a sign in the middle of the opening. The main plaza is to the north and the ape cage is to the south and the lion cage is to the west.

* * *

>x lion
The king of the jungle. It is angry and you can't get near him...maybe you can tame him with some food?

>give lion meat
(first taking Meat)
That seems to belong to Lion.

>put leash on lion
Putting things on Lion would achieve nothing.

* * *

>s
You can't go that way.

>w
You can't go that way.

>e
Lions cage
 The cage for the king of the jungle. You see a scuba tank inside the enclosure.

>x lion
You can't see any such thing.

>e
Safari Zone
A opening with many different animal cages around it. There is a sign in the middle of the opening. The main plaza is to the north and the ape cage is to the south and the lion cage is to the west.

>w
Lions cage
 The cage for the king of the jungle. You see a scuba tank inside the enclosure.

* * *

>x lion
The king of the jungle. It is angry and you can't get near him...maybe you can tame him with some food?

>tell lion to go west
I didn't understand that sentence.

>go west
You can't go that way.

>go east
Lions cage
 The cage for the king of the jungle. You see a scuba tank inside the enclosure.

>w
Pride Rock
The rock where the lions hang out. A big lion is eyeing you 30 ft away.

>lion
That's not a verb I recognise.

>x lion
The king of the jungle. It is angry and you can't get near him...maybe you can tame him with some food?

>bring lion east
That's not a verb I recognise.

>e
Lions cage
 The cage for the king of the jungle. You see a scuba tank inside the enclosure.

>e
Safari Zone
A opening with many different animal cages around it. There is a sign in the middle of the opening. The main plaza is to the north and the ape cage is to the south and the lion cage is to the west.

* * *

>s
Ape Cage
a cage for the most annoying animals on the planet. You see a little monkey smiling at you, and the Alpha monkey dangling your much needed car keys!

>take house key
Alpha monkey bares his teeth and tries to rip your head off. Maybe trying to take them now is not such a good idea...

>take house key
Alpha monkey bares his teeth and tries to rip your head off. Maybe trying to take them now is not such a good idea...

>n
Safari Zone
A opening with many different animal cages around it. There is a sign in the middle of the opening. The main plaza is to the north and the ape cage is to the south and the lion cage is to the west.

* * *

>x lion
The king of the jungle. It is angry and you can't get near him...maybe you can tame him with some food?

>put leash on lion
Putting things on Lion would achieve nothing.

>e
Lions cage
 The cage for the king of the jungle. You see a scuba tank inside the enclosure.

* * *

>e
Safari Zone
A opening with many different animal cages around it. There is a sign in the middle of the opening. The main plaza is to the north and the ape cage is to the south and the lion cage is to the west.

>i
You are carrying:
  Shark tooth
  a scuba tank (being worn)
  Leash

>put leash on lion
You can't see any such thing.

>i
You are carrying:
  Shark tooth
  a scuba tank (being worn)
  Leash

>wear leash
You put on Leash.

>take off leash
You take off Leash.

>wear leash on lion
I only understood you as far as wanting to wear Leash.

>give leash to lion
You can't see any such thing.

>give lion leash
You can't see any such thing.

>i
You are carrying:
  Shark tooth
  a scuba tank (being worn)
  Leash

>give lion leash
You can't see any such thing.

>give leash to lion
You can't see any such thing.

>w
Lions cage
 The cage for the king of the jungle. You see a scuba tank inside the enclosure.

* * *

>w
Pride Rock
The rock where the lions hang out. A big lion is eyeing you 30 ft away.

>give leash to lion
You put the leash on the lion and he will follow you around now! What a awesome pet.

"The lion will follow you around!."

>e
Lions cage
 The cage for the king of the jungle. You see a scuba tank inside the enclosure.

Lion arrives from the west.

>s
You can't go that way.

"The lion will follow you around!."

>e
Safari Zone
A opening with many different animal cages around it. There is a sign in the middle of the opening. The main plaza is to the north and the ape cage is to the south and the lion cage is to the west.

Lion arrives from the west.

>s
Ape Cage
a cage for the most annoying animals on the planet. You see a little monkey smiling at you, and the Alpha monkey dangling your much needed car keys!

Lion arrives from the north.

>take house key
The alpha monkey trips out and runs away like a little baby
"The lion will follow you around!."

you win!

    *** The End ***

Would you like to RESTART, RESTORE a saved game, QUIT or UNDO the last command?

>undo
Ape Cage
[Previous turn undone.]

>take key
The alpha monkey trips out and runs away like a little baby
"The lion will follow you around!."

you win!

    *** The End ***

Would you like to RESTART, RESTORE a saved game, QUIT or UNDO the last command?

* * *

>d
You can't go that way.

* * *

>s
Safari Zone
A opening with many different animal cages around it. There is a sign in the middle of the opening. The main plaza is to the north and the ape cage is to the south and the lion cage is to the west.

>w
Lions cage
 The cage for the king of the jungle. You see a scuba tank on pride rock, which is the west part of the enclosure.

>w
Pride Rock
 The rock where the lions hang out. A big lion is eyeing you 30 ft away. You see a scuba tank right by your feet.

>take tank
Taken.

>e
Lions cage
The cage for the king of the jungle. Pride rock is to the west of the enclosure.

>w
Pride Rock
 The rock where the lions hang out. A big lion is eyeing you 30 ft away.

* * *

>take tank
Taken.

>e
Lions cage
The cage for the king of the jungle. You see a scuba tank inside the enclosure.

>e
Safari Zone
A opening with many different animal cages around it. There is a sign in the middle of the opening. The main plaza is to the north and the ape cage is to the south and the lion cage is to the west.

* * *

>n
Main Plaza
A beautiful open plaza. The bathroom is to the west and the aquatic center is to the east

>n
You can't go that way.

>e
Aquatic Center
A center with many different exibits around it. There is a sign in the middle of the opening and a table in the corner. Tee main plaza is to the west and the dolphin encosure is to the east.

>e
Dolphin enclosure
You are on the balcony of the dolphin enclosure. the water looks very nice and calm. The aquatic center is to the west and the pool is below

>d
you can't enter without air!

>d
you can't enter without air!

>wear tank
You put on the scuba tank.

* * *

>d
you jump into the water.

Pool
the water feels very warm up here, you see some fish down below. The bottom of the pool is below.

>d
Bottom of Pool
 "blub blub" the water is very chilly down here "blub blub" you can see a fish next to "blub blub" some coral on the ground.

>x chest
a beautiful treasure chest layered in diamond with a tooth shaped lock.

>open chest
It seems to be locked.

* * *

>d
You can't go that way.

>w
Bathroom
A quaint little room where people can handle their business. There is a mirror on the wall as well as a cubboard.

>e
Main Plaza

>e
Aquatic Center
A center with many different exibits around it. There is a sign in the middle of the opening.

>e
Dolphin Pool

>d
Bottom of Pool

>e
You can't go that way.

>t
That's not a verb I recognise.

>u
Dolphin Pool

>w
Aquatic Center
A center with many different exibits around it. There is a sign in the middle of the opening.

>w
Main Plaza

>n
You can't go that way.

>s
Safari Zone
A opening with many different animal cages around it. There is a sign in the middle of the opening.

>s
Monkey Cages
a scumbag little monkey that is laughing at you. He seems to have a rope in his hands.

You can see a monkeyy here.

* * *

>e
aquatic center
A center with many different exibits around it. There is a sign in the middle of the opening and a table in the corner. The main plaza is to the west and the dolphin encosure is to the east.

You can see Shark tooth here.

>e
Dolphin enclosure
You are on the balcony of the dolphin enclosure. the water looks very nice and calm. The aquatic center is to the west and the pool is below

>e
You can't go that way.

>d
you can't enter without air!

I beg your pardon?

>d
you can't enter without air!

>dd
That's not a verb I recognise.

>d
you can't enter without air!

* * *

>dd
That's not a verb I recognise.

I beg your pardon?

>w
Aquatic Center
A center with many different exibits around it. There is a sign in the middle of the opening and a table in the corner. Tee main plaza is to the west and the dolphin encosure is to the east.

>d
You can't go that way.

>w
Main Plaza
A beautiful open plaza. The bathroom is to the west and the aquatic center is to the east

>w
Bathroom
A quaint little room where people can handle their business. There is a mirror on the wall as well as a cubboard. A trashcan is in the corner. The Main Plaza is to the east

>e
Main Plaza
A beautiful open plaza. The bathroom is to the west and the aquatic center is to the east

* * *

>s
Ape Cage
a cage for the most annoying animals on the planet. You see a little monkey smiling at you, and the Alpha monkey dangling your much needed car keys!

>e
You can't go that way.

>d
You can't go that way.

>s
You can't go that way.

* * *

>w
You can't go that way.

>e
You can't go that way.

>n
Safari Zone
A opening with many different animal cages around it. There is a sign in the middle of the opening. The main plaza is to the north and the ape cage is to the south and the lion cage is to the west.

>w
Lions cage
The cage for the king of the jungle. You see a scuba tank inside the enclosure.

>w
Pride Rock
The rock where the lions hang out. A big lion is eyeing you 30 ft away.

* * *

>take tank
Taken.

>wear tank
You put on the scuba tank.

>e
Lions cage
The cage for the king of the jungle. You see a scuba tank inside the enclosure.

>n
You can't go that way.

>ne
You can't go that way.

>s
You can't go that way.

>s
You can't go that way.

* * *

>e
Safari Zone
A opening with many different animal cages around it. There is a sign in the middle of the opening. The main plaza is to the north and the ape cage is to the south and the lion cage is to the west.

>e
You can't go that way.

>e
You can't go that way.

>n
Main Plaza
A beautiful open plaza. The bathroom is to the west and the aquatic center is to the east

>e
Aquatic Center
A center with many different exibits around it. There is a sign in the middle of the opening and a table in the corner. Tee main plaza is to the west and the dolphin encosure is to the east.

* * *

>e
Dolphin enclosure
You are on the balcony of the dolphin enclosure. the water looks very nice and calm. The aquatic center is to the west and the pool is below

>d
you jump into the water.

Pool
the water feels very warm up here, you see some fish down below. The bottom of the pool is below.

* * *

>e
You can't go that way.

>d
Pool
the water feels very warm up here, you see some fish down below. The bottom of the pool is below.

* * *

>take shark tooth
Taken.

>s
You can't go that way.

>w
Main Plaza
A beautiful open plaza. The bathroom is to the west and the aquatic center is to the east

>s
Safari Zone
A opening with many different animal cages around it. There is a sign in the middle of the opening. The main plaza is to the north and the ape cage is to the south and the lion cage is to the west.

>w
Lions cage
The cage for the king of the jungle. You see a scuba tank inside the enclosure.

* * *

>take tank
Taken.

>w
You can't go that way.

>e
Lions cage
The cage for the king of the jungle. You see a scuba tank inside the enclosure.

* * *

>n
Main Plaza
A beautiful open plaza. The bathroom is to the west and the aquatic center is to the east

>e
aquatic center
A center with many different exibits around it. There is a sign in the middle of the opening and a table in the corner. The main plaza is to the west and the dolphin encosure is to the east.

>e
Dolphin enclosure
You are on the balcony of the dolphin enclosure. the water looks very nice and calm. The aquatic center is to the west and the pool is below

* * *

>d
Bottom of Pool
 "blub blub" the water is very chilly down here "blub blub" you can see a fish next to "blub blub" a treasure chest.

>x chest
a beautiful treasure chest layered in diamond with a tooth shaped lock.

* * *

>open chest
It seems to be locked.

>unlock chest
What do you want to unlock the treasure chest with?

>unlock chest with shark tooth
You unlock the treasure chest.

* * *

>e
aquatic center
A center with many different exibits around it. There is a sign in the middle of the opening and a table in the corner. The main plaza is to the west and the dolphin encosure is to the east.

You can see Shark tooth here.

>x table
You can't see any such thing.

>take teeth
You can't see any such thing.

>take shark tooth
You can't see any such thing.

>x
(the aquatic sign)
Zone for the most epic water animals of the world. Safari zone cannot hang.

>w
Main Plaza
A beautiful open plaza. The bathroom is to the west and the aquatic center is to the east

* * *

>s
Safari Zone
A opening with many different animal cages around it. There is a sign in the middle of the opening. The main plaza is to the north and the ape cage is to the south and the lion cage is to the west.

>e
You can't go that way.

>w
Lions cage
The cage for the king of the jungle. You see a scuba tank inside the enclosure.

* * *

>w
Pride Rock
The rock where the lions hang out. A big lion is eyeing you 30 ft away.

>take scuba tank
Taken.

>e
Lions cage
The cage for the king of the jungle. You see a scuba tank inside the enclosure.

>e
Safari Zone
A opening with many different animal cages around it. There is a sign in the middle of the opening

>n
Main Plaza

>e
Aquatic Center
A center with many different exibits around it. There is a sign in the middle of the opening and a table in the corner

>e
Dolphin enclosure
You are on the balcony of the dolphin enclosure. the water looks very nice and calm.

>d
Pool
the water feels very warm up here, you see some fish down below.

>d
You can't go that way.

>d
You can't go that way.

* * *

>e
You can't go that way.

>n
Safari Zone
A opening with many different animal cages around it. There is a sign in the middle of the opening.

>n
Main Plaza

>w
Bathroom
A quaint little room where people can handle their business. There is a mirror on the wall as well as a cubboard. A trashcan is in the corner

>x trashcan
a groddy trashcan

>open trashcan
You open the trashcan, revealing Apple.

* * *

>take apple
Taken.

>x apple
a half eaten apple

>e
Main Plaza

* * *

>e
Aquatic Center
A center with many different exibits around it. There is a sign in the middle of the opening.

>w
Main Plaza

>s
Safari Zone
A opening with many different animal cages around it. There is a sign in the middle of the opening.

>s
Ape Cage
You can see a monkey here.

>x monkey
a scumbag little monkey that is laughing at you. He seems to have a rope in his hands.

>give monkey apple
The monkey doesn't seem interested.

>take rope
The monkey holds on to the rope. Maybe he's hungry?

>offer monkey apple
The monkey doesn't seem interested.

>give
(the monkey Apple)
The monkey doesn't seem interested.

>give apple
(to the monkey)
The monkey doesn't seem interested.

>give monkey
(Apple)
The monkey doesn't seem interested.

>offer monkey
(Apple)
The monkey doesn't seem interested.

>offer apple
(to the monkey)
The monkey doesn't seem interested.

>offer apple to the monkey
The monkey doesn't seem interested.

>push monkey
The monkey might not like that.

>fight monkey
Violence isn't the answer to this one.

>kill monkey
Violence isn't the answer to this one.

>attack monkey
Violence isn't the answer to this one.

>stab monkey
That's not a verb I recognise.

>eat monkey
He's plainly inedible.

* * *

>n
Safari Zone
A opening with many different animal cages around it. There is a sign in the middle of the opening. The main plaza is to the north and the ape cage is to the south and the lion cage is to the west.

>e
You can't go that way.

* * *

>d
you can't enter without air!

>wear tnak
You can't see any such thing.

>wear tank
You put on the scuba tank.

* * *

>d
you jump into the water.

Pool
the water feels very warm up here, you see some fish down below. The bottom of the pool is below.

>d
Bottom of Pool
 "blub blub" the water is very chilly down here "blub blub" you can see a fish next to "blub blub" some coral on the ground.

You can see a treasure chest (closed) here.

>open chest
It seems to be locked.

>x chest
You see nothing special about the treasure chest.

>examine treasure chest
You see nothing special about the treasure chest.

>x chest
You see nothing special about the treasure chest.

>w
You can't go that way.

I beg your pardon?

>d
You can't go that way.

>n
You can't go that way.

* * *

>u
Dolphin enclosure
You are on the balcony of the dolphin enclosure. the water looks very nice and calm. The aquatic center is to the west and the pool is below

>w
Aquatic Center
A center with many different exibits around it. There is a sign in the middle of the opening and a table in the corner. Tee main plaza is to the west and the dolphin encosure is to the east.

>w
Main Plaza
A beautiful open plaza. The bathroom is to the west and the aquatic center is to the east

* * *

>w
Bathroom
A quaint little room where people can handle their business. There is a mirror on the wall as well as a cubboard. A trashcan is in the corner. The Main Plaza is to the east

>x mirro
You can't see any such thing.

>xmirror
That's not a verb I recognise.

>x mirror
an ugly man melts out of the mirror causing you to panic...when suddenly you realize it is you.

>x trashcan
a groddy trashcan

* * *

>d
you jump into the water.

Pool
the water feels very warm up here, you see some fish down below. The bottom of the pool is below.

>d
Bottom of Pool
 "blub blub" the water is very chilly down here "blub blub" you can see a fish next to "blub blub" some coral on the ground.

You can see a treasure (closed) here.

>open treasure
You open the treasure.

* * *

>n
Safari Zone
A opening with many different animal cages around it. There is a sign in the middle of the opening. The main plaza is to the north and the ape cage is to the south and the lion cage is to the west.

>x sign
Zone for the most land epic animals of the world. Aquatic zone cannot hang.

>s
Ape Cage
a cage for the most annoying animals on the planet. You see a little monkey smiling at you, and the Alpha monkey dangling your much needed car keys!

You can see an Alpha and a monkey here.

* * *

>s
Ape Cage
a cage for the most annoying animals on the planet. You see a little monkey smiling at you, and the Alpha monkey dangling your much needed car keys!

>w
You can't go that way.

>n
Safari Zone
A opening with many different animal cages around it. There is a sign in the middle of the opening. The main plaza is to the north and the ape cage is to the south and the lion cage is to the west.

* * *

>w
Bathroom
A quaint little room where people can handle their business. There is a mirror on the wall as well as a cubboard. A trashcan is in the corner. The Main Plaza is to the east

>take collar
You can't see any such thing.

>open cubboard
You open the cubboard, revealing a collar.

* * *

>take collar
Taken.

>open trashcan
You open the trashcan, revealing Apple.

* * *

>take apple
Taken.

>w
You can't go that way.

>e
Main Plaza
A beautiful open plaza. The bathroom is to the west and the aquatic center is to the east

>e
aquatic center
A center with many different exibits around it. There is a sign in the middle of the opening and a table in the corner. The main plaza is to the west and the dolphin encosure is to the east.

You can see Shark tooth here.

* * *

>take shark tooth
Taken.

>w
Main Plaza
A beautiful open plaza. The bathroom is to the west and the aquatic center is to the east

* * *

>s
Ape Cage
a cage for the most annoying animals on the planet. You see a little monkey smiling at you, and the Alpha monkey dangling your much needed car keys!

>give monkey apple
the monkey looks at the nasty little half eaten apple and starts devouring the little morsel

>take leash
You can't see any such thing.

>take rope
monkey is distracted by his tasty apple and you steal the rope

* * *

>n
Main Plaza
A beautiful open plaza. The bathroom is to the west and the aquatic center is to the east

>s
Safari Zone
A opening with many different animal cages around it. There is a sign in the middle of the opening. The main plaza is to the north and the ape cage is to the south and the lion cage is to the west.

>n
Main Plaza
A beautiful open plaza. The bathroom is to the west and the aquatic center is to the east

* * *

>d
Bottom of Pool
 "blub blub" the water is very chilly down here "blub blub" you can see a fish next to "blub blub" a treasure chest.

>open treasure chest
It seems to be locked.

>use shark tooth
That's not a verb I recognise.

>unlock chest
What do you want to unlock the treasure chest with?

>unlock chest with sharktooth
You can't see any such thing.

>i
You are carrying:
  Leash
  Shark tooth
  a scuba tank (being worn)

>unlock chest with shark tooth
You unlock the treasure chest.

>x chest
a beautiful treasure chest layered in diamond with a tooth shaped lock.

>take meat
You can't see any such thing.

>take meat
You can't see any such thing.

>x meat
You can't see any such thing.

>meat
That's not a verb I recognise.

>take meat
You can't see any such thing.

>take all
There are none at all available!

>x chest
a beautiful treasure chest layered in diamond with a tooth shaped lock.

>i
You are carrying:
  Leash
  Shark tooth
  a scuba tank (being worn)

>open chest
You open the treasure chest, revealing Meat.

>take meat
Taken.

>u
you jump into the water.

Pool
the water feels very warm up here, you see some fish down below. The bottom of the pool is below.

* * *

>x lion
The king of the jungle. It is angry and you can't get near him...maybe you can tame him with some food?

>give meat to lion
Lion devours the piece of meat and starts cuddling with you.

>put leash on lion
You put the leash on the lion and he will follow you around now! What a awesome pet.

>w
You can't go that way.

* * *

>s
Ape Cage
a cage for the most annoying animals on the planet. You see a little monkey smiling at you, and the Alpha monkey dangling your much needed car keys!

>x alpha monkey
I only understood you as far as wanting to examine the Alpha.

>x alpha
 a huge monkey that can be mistaken for a gorilla. He has teeth the size of tigers, as much muscle as a horse and claws the size of a pointer finger . Only a king can rival him...

>take keys
You can't see any such thing.

>take house keys
I only understood you as far as wanting to take the house key.

>take house key
Alpha monkey bares his teeth and tries to rip your head off. Maybe trying to take them now is not such a good idea...

* * *

>s
Ape Cage
a cage for the most annoying animals on the planet. You see a little monkey smiling at you, and the Alpha monkey dangling your much needed car keys!

>x alpha
 a huge monkey that can be mistaken for a gorilla. He has teeth the size of tigers, as much muscle as a horse, claws as sharp as knives. Only a king can rival him...

* * *

>s
Ape Cage
a cage for the most annoying animals on the planet. You see a little monkey smiling at you, and the Alpha monkey dangling your much needed car keys!

>x little monkey
You can't see any such thing.

>x monkey
a scumbag little monkey that is laughing at you. He seems to have a rope in his hands.

>x alpha
You see nothing special about the Alpha.

* * *

>s
Ape Cage
a cage for the most annoying animals on the planet. You see a little monkey smiling at you, and the Alpha monkey dangling your much needed car keys!

>x monkey
a scumbag little monkey that is laughing at you. He seems to have a rope in his hands.

>take rope
Taken.

* * *

>e
Lions cage
The cage for the king of the jungle.

>e
Safari Zone
A opening with many different animal cages around it. There is a sign in the middle of the opening

* * *

>w
Bathroom
A quaint little room where people can handle their business. There is a mirror on the wall as well as a cubboard. A trashcan is in the corner

>e
Main Plaza

>e
Aquatic Center
A center with many different exibits around it. There is a sign in the middle of the opening and a table in the corner

* * *

>d
Bottom of Pool
 "blub blub" the water is very chilly down here "blub blub" you can see a fish next to "blub blub" some coral on the ground.

You can see a treasure chest (closed) here.

>x chest
You see nothing special about the treasure chest.

>x treasure chest
You see nothing special about the treasure chest.

* * *

>take tank
Taken.

>wear tankl
You can't see any such thing.

>wear tank
You put on the scuba tank.

* * *

>w
Bathroom
A quaint little room where people can handle their business. There is a mirror on the wall as well as a cubboard. A trashcan is in the corner. The Main Plaza is to the east

>e
Main Plaza
A beautiful open plaza. The bathroom is to the west and the aquatic center is to the east and the safari zone is to the south.

>e
aquatic center
A center with many different exibits around it. There is a sign in the middle of the opening and a table in the corner. The main plaza is to the west and the dolphin encosure is to the east.

>e
Dolphin Pool

* * *

>e
aquatic center
A center with many different exibits around it. There is a sign in the middle of the opening and a table in the corner. The main plaza is to the west and the dolphin encosure is to the east.

>x table
 a brown table. You see a sharktooth sticking out of the wood.

>take sharktooth
Taken.

>x table
 a brown table.

* * *

>take apple
Taken.

>e
Main Plaza
A beautiful open plaza. The bathroom is to the west and the aquatic center is to the east and the safari zone is to the south.

>s
Safari Zone
A opening with many different animal cages around it. There is a sign in the middle of the opening. The main plaza is to the north and the ape cage is to the south and the lion cage is to the west.

* * *

>s
Ape Cage
a cage for the most annoying animals on the planet. You see a little monkey smiling at you, and the Alpha monkey dangling your much needed car keys!

>give monkey apple
the monkey looks at the nasty little half eaten apple and starts devouring the little morsel. Quick! he is now distracted.

>take rope
monkey is distracted by his tasty apple and you steal the rope

* * *

>n
Safari Zone
A opening with many different animal cages around it. There is a sign in the middle of the opening. The main plaza is to the north and the ape cage is to the south and the lion cage is to the west.

>w
Lions cage
 The cage for the king of the jungle. You see a scuba tank on pride rock, which is the west part of the enclosure.

* * *

>e
Lions cage
The cage for the king of the jungle. Pride rock is to the west of the enclosure.

>e
Safari Zone
A opening with many different animal cages around it. There is a sign in the middle of the opening. The main plaza is to the north and the ape cage is to the south and the lion cage is to the west.

>n
Main Plaza
A beautiful open plaza. The bathroom is to the west and the aquatic center is to the east and the safari zone is to the south.

>e
aquatic center
A center with many different exibits around it. There is a sign in the middle of the opening and a table in the corner. The main plaza is to the west and the dolphin encosure is to the east.

>take sharktooth
Taken.

>w
Main Plaza
A beautiful open plaza. The bathroom is to the west and the aquatic center is to the east and the safari zone is to the south.

>e
aquatic center
A center with many different exibits around it. There is a sign in the middle of the opening and a table in the corner. The main plaza is to the west and the dolphin encosure is to the east.

* * *

>e
You can't go that way.

>wear tank
You put on the scuba tank.

>d
you jump into the water.

Pool
the water feels very warm up here, you see some fish down below. The bottom of the pool is below and the dolphin enclosure is up.

>x fish
beautiful colored fish swimming around.

>d
Bottom of Pool
 "blub blub" the water is very chilly down here "blub blub" you can see a "blub blub" a treasure chest.

>x fish
You can't see any such thing.

>open chest with tooth
You unlock the treasure chest.

>open chest
You open the treasure chest, revealing Meat.

* * *

>take meat
Taken.

>u
you jump into the water.

Pool
the water feels very warm up here, you see some fish down below. The bottom of the pool is below and the dolphin enclosure is up.

I beg your pardon?

>u
Dolphin enclosure
You are on the balcony of the dolphin enclosure. the water looks very nice and calm. The aquatic center is to the west and the pool is below

* * *

>w
aquatic center
A center with many different exibits around it. There is a sign in the middle of the opening and a table in the corner. The main plaza is to the west and the dolphin encosure is to the east.

>d
You can't go that way.

>w
Main Plaza
A beautiful open plaza. The bathroom is to the west and the aquatic center is to the east and the safari zone is to the south.

>d
You can't go that way.

* * *

>w
Pride Rock
 The rock where the lions hang out. A big lion is eyeing you 30 ft away. You see a scuba tank right by your feet.

>give meat to lion
Lion devours the piece of meat and starts cuddling with you. If only you had a leash to make him your pet...

>put leash on lion
You put the leash on the lion and he will follow you around now! What a awesome pet.

"The lion will follow you around!."

>give leash to lion
(first taking Leash)
That seems to belong to Lion.

"The lion will follow you around!."

>e
Lions cage
 The cage for the king of the jungle. You see a scuba tank on pride rock, which is the west part of the enclosure.

Lion arrives from the west.

>e
Safari Zone
A opening with many different animal cages around it. There is a sign in the middle of the opening. The main plaza is to the north and the ape cage is to the south and the lion cage is to the west.

Lion arrives from the west.

>d
You can't go that way.

"The lion will follow you around!."

>s
Ape Cage
a cage for the most annoying animals on the planet. You see a little monkey smiling at you, and the Alpha monkey dangling your much needed car keys!

Lion arrives from the north.

>take keys
The alpha monkey trips out and runs away like a little baby
"The lion will follow you around!."

you win!

    *** The End ***

Would you like to RESTART, RESTORE a saved game, QUIT or UNDO the last command?

>undo
Ape Cage
[Previous turn undone.]

>undo
Safari Zone
[Previous turn undone.]

>unod
That's not a verb I recognise.

>undo
Safari Zone
[Previous turn undone.]

>undo
Safari Zone
[Previous turn undone.]

>undo
Lions cage
[Previous turn undone.]

>undoundo
That's not a verb I recognise.

>undo
Lions cage
[Previous turn undone.]

>undo
Pride Rock
[Previous turn undone.]

>undo
Pride Rock
[Previous turn undone.]

>undo
"Undo" capacity exhausted. Sorry!

>x lion
The king of the jungle. It is angry and you can't get near him...maybe you can tame him with some food?

>give lion peat
You can't see any such thing.

>give lion meat
Lion devours the piece of meat and starts cuddling with you. If only you had a leash to make him your pet...

>put leash on lion
You put the leash on the lion and he will follow you around now! What a awesome pet.

"The lion will follow you around!."

>put
What do you want to put on?

>put leash
What do you want to put Leash in?

>put leash to lion
I didn't understand that sentence.

>give leash to lion
(first taking Leash)
That seems to belong to Lion.

"The lion will follow you around!."

>take leash from lion
That seems to belong to Lion.

"The lion will follow you around!."

>undo
Pride Rock
[Previous turn undone.]

>x lion
The king of the jungle. It is angry and you can't get near him...maybe you can tame him with some food?

"The lion will follow you around!."

>undo
Pride Rock
[Previous turn undone.]

* * *

>x lion
The king of the jungle. It is angry and you can't get near him...maybe you can tame him with some food?

"The lion will follow you around!."

>i
You are carrying:
  Shark tooth
  a scuba tank (being worn)

"The lion will follow you around!."

* * *

>take collar
Taken.

>xcollar
That's not a verb I recognise.

>x collar
a big black collar with spikes on the outside. its so big you can fit it around barney the dinosaur!

>open trashcan
You open the trashcan, revealing Apple.

* * *

>x apple
a half eaten apple

>x trashcan
a groddy trashcan

>s
You can't go that way.

* * *

>w
You can't go that way.

>e
Main Plaza

>s
Safari Zone
A opening with many different animal cages around it. There is a sign in the middle of the opening.

* * *

>s
Ape Cage
You can see a monkey here.

>n
Safari Zone
A opening with many different animal cages around it. There is a sign in the middle of the opening.

>x sign
Zone for the most land epic animals of the world. Aquatic zone cannot hang.

>w
Pride Rock

>s
You can't go that way.

>e
Safari Zone
A opening with many different animal cages around it. There is a sign in the middle of the opening.

>s
Ape Cage
You can see a monkey here.

* * *

>x monkey
a scumbag little monkey that is laughing at you. He seems to have a rope in his hands.

>take rope
The monkey holds on to the rope. Maybe he's hungry?

>give apple to monkey
The monkey doesn't seem interested.

>trade apple
That's not a verb I recognise.

>tke rope
That's not a verb I recognise.

>take rope
The monkey holds on to the rope. Maybe he's hungry?

* * *

>take apple
Taken.

>e
Main Plaza

* * *

>s
Ape Cage
You can see a monkey here.

>give apple
(to the monkey)
the monkey looks at the nasty little half eaten apple and starts devouring the little morsel

>take rope
monkey is distracted by his tasty apple and you steal the rope

>i
You are carrying:
  a rope

>s
You can't go that way.

* * *

>w
You can't go that way.

>n
Safari Zone
A opening with many different animal cages around it. There is a sign in the middle of the opening.

* * *

>n
Main Plaza

>e
Aquatic Center
A center with many different exibits around it. There is a sign in the middle of the opening.

* * *

>w
Main Plaza

>w
Bathroom
A quaint little room where people can handle their business. There is a mirror on the wall as well as a cubboard. A trashcan is in the corner

>x mirror
You can't see any such thing.

>x cubboard
a wooden cubboard, there may be something inside

>open cubboard
You open the cubboard, revealing a collar.

>take colar
You can't see any such thing.

>take collar
Taken.

>combine collar with rope
You combine the rope and collar to make a leash.

>i
You are carrying:
  Leash

* * *

>take rope
The monkey holds on to the rope. Maybe he's hungry?

>hold apple
You already have that.

>take roope
You can't see any such thing.

>take rope
The monkey holds on to the rope. Maybe he's hungry?

>give monkey apple
The monkey doesn't seem interested.

>give monkey apple
The monkey doesn't seem interested.

>i
You are carrying:
  Apple

* * *

>w
Bathroom
A quaint little room where people can handle their business. There is a mirror on the wall as well as a cubboard. A trashcan is in the corner. The Main Plaza is to the east

>take all
There are none at all available!

>take all
There are none at all available!

>e
Main Plaza
A beautiful open plaza. The bathroom is to the west and the aquatic center is to the east and the safari zone is to the south.

* * *

>e
aquatic center
A center with many different exibits around it. There is a sign in the middle of the opening and a table in the corner. The main plaza is to the west and the dolphin encosure is to the east.

>take all
There are none at all available!

>w
Main Plaza
A beautiful open plaza. The bathroom is to the west and the aquatic center is to the east and the safari zone is to the south.

* * *

>w
Pride Rock
 The rock where the lions hang out. A big lion is eyeing you 30 ft away. You see a scuba tank right by your feet.

>take all
There are none at all available!

>take tank
Taken.

* * *

>w
Bathroom
A quaint little room where people can handle their business. There is a mirror on the wall as well as a cubboard. A trashcan is in the corner. The Main Plaza is to the east

>take apple
You can't see any such thing.

>open trashcan
You open the trashcan, revealing Apple.

* * *

>s
Ape Cage
You can see a monkey here.

>give apple to monkey
the monkey looks at the nasty little half eaten apple and starts devouring the little morsel

>take rope
The monkey holds on to the rope. you have to distract him. Maybe with some food?

>i
You are carrying:
  Apple

* * *

>take apple
You can't see any such thing.

>take collar
You can't see any such thing.

* * *

>w
You can't go that way.

>e
Main Plaza
A beautiful open plaza. The bathroom is to the west and the aquatic center is to the east and the safari zone is to the south.

* * *

>e
aquatic center
A center with many different exibits around it. There is a sign in the middle of the opening and a table in the corner. The main plaza is to the west and the dolphin encosure is to the east.

>take tooth
Taken.

>w
Main Plaza
A beautiful open plaza. The bathroom is to the west and the aquatic center is to the east and the safari zone is to the south.

* * *

>w
Pride Rock
 The rock where the lions hang out. A big lion is eyeing you 30 ft away. You see a scuba tank right by your feet.

>take tan
You can't see any such thing.

>take tank
Taken.

* * *

>e
Safari Zone
A opening with many different animal cages around it. There is a sign in the middle of the opening. The main plaza is to the north and the ape cage is to the south and the lion cage is to the west.

>w
Lions cage
The cage for the king of the jungle. Pride rock is to the west of the enclosure.

>w
Pride Rock
 The rock where the lions hang out. A big lion is eyeing you 30 ft away.

>e
Lions cage
The cage for the king of the jungle. Pride rock is to the west of the enclosure.

* * *

>n
Main Plaza
A beautiful open plaza. The bathroom is to the west and the aquatic center is to the east and the safari zone is to the south.

>n
You can't go that way.

>e
aquatic center
A center with many different exibits around it. There is a sign in the middle of the opening and a table in the corner. The main plaza is to the west and the dolphin encosure is to the east.

* * *

>d
you jump into the water.

Pool
the water feels very warm up here, you see some fish down below. The bottom of the pool is below and the dolphin enclosure is up.

>d
Bottom of Pool
 "blub blub" the water is very chilly down here "blub blub" you can see a "blub blub" a treasure chest.

>unlock chest with tooth
You unlock the treasure chest.

>open chest
You open the treasure chest, revealing Meat.

* * *

>u
you jump into the water.

Pool
the water feels very warm up here, you see some fish down below. The bottom of the pool is below and the dolphin enclosure is up.

>u
Dolphin enclosure
You are on the balcony of the dolphin enclosure. the water looks very nice and calm. The aquatic center is to the west and the pool is below

* * *

>w
aquatic center
A center with many different exibits around it. There is a sign in the middle of the opening and a table in the corner. The main plaza is to the west and the dolphin encosure is to the east.

>w
Main Plaza
A beautiful open plaza. The bathroom is to the west and the aquatic center is to the east and the safari zone is to the south.

* * *

>d
You can't go that way.

I beg your pardon?

>s
Safari Zone
A opening with many different animal cages around it. There is a sign in the middle of the opening. The main plaza is to the north and the ape cage is to the south and the lion cage is to the west.

* * *

>w
Pride Rock
 The rock where the lions hang out. A big lion is eyeing you 30 ft away. You see a scuba tank right by your feet.

>give lion meat
Lion devours the piece of meat and starts cuddling with you. If only you had a leash to make him your pet...

>put collar on lion
You can't see any such thing.

>put leash on lion
You put the leash on the lion and he will follow you around now! What a awesome pet.

"The lion will follow you around!."

* * *

>w
Bathroom
A quaint little room where people can handle their business. There is a mirror on the wall as well as a cubboard. A trashcan is in the corner. The Main Plaza is to the east

>take trashcan
its too heavy you silly goose.

I beg your pardon?

* * *

>w
Bathroom
A quaint little room where people can handle their business. There is a mirror on the wall as well as a cubboard. A trashcan is in the corner. The Main Plaza is to the east

>w
You can't go that way.

* * *

>e
Main Plaza
A beautiful open plaza. The bathroom is to the west and the aquatic center is to the east

>d
You can't go that way.

>e
Aquatic Center

>e
Dolphin Pool

* * *

>d
Bottom of Pool

>u
Dolphin Pool

>e
You can't go that way.

>w
Aquatic Center

>w
Main Plaza

>s
Safari Zone

I beg your pardon?

>s
Monkey Cages

>n
Safari Zone

>w
Pride Rock

>w
Lions Den

>w
You can't go that way.

* * *

>e
Main Plaza
A beautiful open plaza. The bathroom is to the west and the aquatic center is to the east

>e
Aquatic Center
A center with many different exibits around it. There is a sign in the middle of the opening and a table in the corner. Tee main plaza is to the west and the dolphin encosure is to the east.

* * *

>e
Dolphin enclosure
You are on the balcony of the dolphin enclosure. the water looks very nice and calm. The aquatic center is to the west and the pool is below

>d
Pool
the water feels very warm up here, you see some fish down below. The bottom of the pool is below.

>d
Bottom of Pool
 "blub blub" the water is very chilly down here "blub blub" you can see a fish next to "blub blub" some coral on the ground.

>i
You are carrying nothing.

* * *

>e
Dolphin enclosure
You are on the balcony of the dolphin enclosure. the water looks very nice and calm. The aquatic center is to the west and the pool is below

>s
You can't go that way.

>n
You can't go that way.

>d
Pool
the water feels very warm up here, you see some fish down below.

>d
Bottom of Pool
 "blub blub" the water is very chilly down here "blub blub" you can see a fish next to "blub blub" some coral on the ground.

* * *

>w
You can't go that way.

>x trashcan
a groddy trashcan

* * *

>take apple
Taken.

I beg your pardon?

>e
Main Plaza

* * *

>s
Ape Cage
You can see a monkey here.

>x monkety
You can't see any such thing.

>xmonkey
That's not a verb I recognise.

>x monkey
a scumbag little monkey that is laughing at you. He seems to have a rope in his hands.

>take rope
The monkey holds on to the rope. you have to distract him. Maybe with some food?

>give apple to monkey
the monkey looks at the nasty little half eaten apple and starts devouring the little morsel

* * *

>take rope
The monkey holds on to the rope. you have to distract him. Maybe with some food?

>take rope
The monkey holds on to the rope. you have to distract him. Maybe with some food?

* * *

>w
Bathroom
A quaint little room where people can handle their business. There is a mirror on the wall as well as a cubboard. A trashcan is in the corner. The Main Plaza is to the east

>x cubboard
a wooden cubboard, there may be something inside

>open cubborad
You can't see any such thing.

>open cubboard
You open the cubboard, revealing nothing.

>take collar
Taken.

* * *

>w
Bathroom
A quaint little room where people can handle their business. There is a mirror on the wall as well as a cubboard. A trashcan is in the corner. The Main Plaza is to the east

>x mirror
an ugly man melts out of the mirror causing you to panic...when suddenly you realize it is you.

>x cubboard
a wooden cubboard, there may be something inside

>open cubbard
You can't see any such thing.

>open cubboard
You open the cubboard, revealing a collar.

>x collar
a big black collar with spikes on the outside. its so big you can fit it around barney the dinosaur!

>take collar
Taken.

>x trashcan
a nasty trashcan

>e
Main Plaza
A beautiful open plaza. The bathroom is to the west and the aquatic center is to the east and the safari zone is to the south.

>e
aquatic center
A center with many different exibits around it. There is a sign in the middle of the opening and a table in the corner. The main plaza is to the west and the dolphin encosure is to the east.

You can see Shark tooth here.

>x sign
Zone for the most epic water animals of the world. Safari zone cannot hang.

>x table
You can't see any such thing.

>x sharktooth
a sharp object that is brownish white. Sharks need to brush their teeth more!

>take shark tooth
Taken.

* * *

>d
you can't enter without air!

>w
aquatic center
A center with many different exibits around it. There is a sign in the middle of the opening and a table in the corner. The main plaza is to the west and the dolphin encosure is to the east.

* * *

>w
Main Plaza
A beautiful open plaza. The bathroom is to the west and the aquatic center is to the east and the safari zone is to the south.

>s
Safari Zone
A opening with many different animal cages around it. There is a sign in the middle of the opening. The main plaza is to the north and the ape cage is to the south and the lion cage is to the west.

>x sign
Zone for the most land epic animals of the world. Aquatic zone cannot hang.

>s
Ape Cage
a cage for the most annoying animals on the planet. You see a little monkey smiling at you, and the Alpha monkey dangling your much needed car keys!

>x monkey
a cheeky little monkey that is laughing at you. He seems to have a rope in his hands.

>take rope
The monkey holds on to the rope. you have to distract him. Maybe with some food?

>n
Safari Zone
A opening with many different animal cages around it. There is a sign in the middle of the opening. The main plaza is to the north and the ape cage is to the south and the lion cage is to the west.

* * *

>w
Pride Rock
 The rock where the lions hang out. A big lion is eyeing you 30 ft away. You see a scuba tank right by your feet.

>take scuba tank
Taken.

>e
Lions cage
The cage for the king of the jungle. Pride rock is to the west of the enclosure.

* * *

>d
you can't enter without air!

>wear scuba tank
You put on the scuba tank.

>d
you jump into the water.

Pool
the water feels very warm up here, you see some fish down below. The bottom of the pool is below and the dolphin enclosure is up.

>d
Bottom of Pool
 "blub blub" the water is very chilly down here "blub blub" you can see a fish next to "blub blub" a treasure chest.

>x fish
You can't see any such thing.

>x treasure chest
a beautiful treasure chest layered in diamond with a tooth shaped lock.

>unlock treasure chest
What do you want to unlock the treasure chest with?

>shark tooth
You unlock the treasure chest.

>open treasure chest
You open the treasure chest, revealing Meat.

* * *

>u
Dolphin enclosure
You are on the balcony of the dolphin enclosure. the water looks very nice and calm. The aquatic center is to the west and the pool is below

>e
You can't go that way.

>s
You can't go that way.

* * *

>n
You can't go that way.

>w
aquatic center
A center with many different exibits around it. There is a sign in the middle of the opening and a table in the corner. The main plaza is to the west and the dolphin encosure is to the east.

* * *

>take rope
The monkey holds on to the rope. you have to distract him. Maybe with some food?

>give meat to monkey
Monkey laughts in your face and runs around shrieking

>s
You can't go that way.

* * *

>give meat to lion
Lion devours the piece of meat and starts cuddling with you. If only you had a leash to make him your pet...

>put collar on lion
Putting things on Lion would achieve nothing.

>i
You are carrying:
  a scuba tank (being worn)
  Shark tooth
  a collar

>give collar to lion
lion charges at you and you barely dodge his attack. He doesn't want to be friends.

>pet lion
That's not a verb I recognise.

>n
You can't go that way.

>e
Lions cage
 The cage for the king of the jungle. You see a scuba tank on pride rock, which is the west part of the enclosure.

>w
Pride Rock
 The rock where the lions hang out. A big lion is eyeing you 30 ft away. You see a scuba tank right by your feet.

>e
Lions cage
 The cage for the king of the jungle. You see a scuba tank on pride rock, which is the west part of the enclosure.

>e
Safari Zone
A opening with many different animal cages around it. There is a sign in the middle of the opening. The main plaza is to the north and the ape cage is to the south and the lion cage is to the west.

* * *

>e
You can't go that way.

>n
Main Plaza
A beautiful open plaza. The bathroom is to the west and the aquatic center is to the east and the safari zone is to the south.

>w
Bathroom
A quaint little room where people can handle their business. There is a mirror on the wall as well as a cubboard. A trashcan is in the corner. The Main Plaza is to the east

>x trashcan
a nasty trashcan

>take trashcan
Taken.

>search trashcan
You can't see inside, since the trashcan is closed.

>open trashcan
You open the trashcan, revealing Apple.

* * *

>n
You can't go that way.

>e
Main Plaza
A beautiful open plaza. The bathroom is to the west and the aquatic center is to the east and the safari zone is to the south.

* * *

>s
Ape Cage
a cage for the most annoying animals on the planet. You see a little monkey smiling at you, and the Alpha monkey dangling your much needed car keys!

>give apple to monkey
the monkey looks at the nasty little half eaten apple and starts devouring the little morsel. Quick! he is now distracted.

>take rope
monkey is distracted by his tasty apple and you steal the rope

>w
You can't go that way.

* * *

>w
Pride Rock
 The rock where the lions hang out. A big lion is eyeing you 30 ft away. You see a scuba tank right by your feet.

>i
You are carrying:
  a rope
  a trashcan (open but empty)
  a scuba tank (being worn)
  Shark tooth
  a collar

>put rope around lion
I didn't understand that sentence.

>put rope on lion
Putting things on Lion would achieve nothing.

>put collar around lion
I didn't understand that sentence.

>combine rope with collar
You combine the rope and collar to make a leash.

>put leash on lion
Putting things on Lion would achieve nothing.

>put leash around lion
I didn't understand that sentence.

>give leash to lion
You put the leash on the lion and he will follow you around now! What a awesome pet.

"The lion will follow you around!."

>e
Lions cage
 The cage for the king of the jungle. You see a scuba tank on pride rock, which is the west part of the enclosure.

Lion arrives from the west.

* * *

>s
Ape Cage
a cage for the most annoying animals on the planet. You see a little monkey smiling at you, and the Alpha monkey dangling your much needed car keys!

Lion arrives from the north.

>x alpha
 a huge monkey that can be mistaken for a gorilla. He has teeth the size of tigers, as much muscle as a horse and claws the size of a pointer finger . Only a king can rival him... and he has your keys!

"The lion will follow you around!."

>make lion fight monkey
That's not a verb I recognise.

>open cage
You can't see any such thing.

>make lion fight alpha monkey
That's not a verb I recognise.

>take key
The alpha monkey trips out and runs away like a little baby
"The lion will follow you around!."

you win!

    *** The End ***

Would you like to RESTART, RESTORE a saved game, QUIT or UNDO the last command?

>x me
Please give one of the answers above.

Would you like to RESTART, RESTORE a saved game, QUIT or UNDO the last command?

>undo
Ape Cage
[Previous turn undone.]

>x me
As good-looking as ever.

"The lion will follow you around!."

* * *

>x mirror
an ugly man melts out of the mirror causing you to panic...when suddenly you realize it is you.

>x trashcan
a nasty trashcan

>open trashcan
You open the trashcan, revealing Apple.

* * *

>take apple
Taken.

>open cubboard
You open the cubboard, revealing a collar.

* * *

>take collar
Taken.

>s
You can't go that way.

>e
Main Plaza
A beautiful open plaza. The bathroom is to the west and the aquatic center is to the east and the safari zone is to the south.

* * *

>take rope
The monkey holds on to the rope. you have to distract him. Maybe with some food?

>x alpha
 a huge monkey that can be mistaken for a gorilla. He has teeth the size of tigers, as much muscle as a horse and claws the size of a pointer finger . Only a king can rival him... and he has your keys!

>take keys
Alpha monkey bares his teeth and tries to rip your head off. Maybe trying to take them now is not such a good idea...

>n
Safari Zone
A opening with many different animal cages around it. There is a sign in the middle of the opening. The main plaza is to the north and the ape cage is to the south and the lion cage is to the west.

>s
Ape Cage
a cage for the most annoying animals on the planet. You see a little monkey smiling at you, and the Alpha monkey dangling your much needed car keys!

* * *

>take scuba tank
Taken.

>x lion
The king of the jungle. It is angry and you can't get near him...maybe you can tame him with some food?

>give apple to lion
lion charges at you and you barely dodge his attack. He doesn't want to be friends.

>w
You can't go that way.

>s
You can't go that way.

>e
Lions cage
The cage for the king of the jungle. Pride rock is to the west of the enclosure.

>s
You can't go that way.

* * *

>n
You can't go that way.

>e
Safari Zone
A opening with many different animal cages around it. There is a sign in the middle of the opening. The main plaza is to the north and the ape cage is to the south and the lion cage is to the west.

* * *

>give apple to monkey
the monkey looks at the nasty little half eaten apple and starts devouring the little morsel. Quick! he is now distracted.

>take keys
Alpha monkey bares his teeth and tries to rip your head off. Maybe trying to take them now is not such a good idea...

>take rope
monkey is distracted by his tasty apple and you steal the rope

>n
Safari Zone
A opening with many different animal cages around it. There is a sign in the middle of the opening. The main plaza is to the north and the ape cage is to the south and the lion cage is to the west.

>n
Main Plaza
A beautiful open plaza. The bathroom is to the west and the aquatic center is to the east and the safari zone is to the south.

>e
aquatic center
A center with many different exibits around it. There is a sign in the middle of the opening and a table in the corner. The main plaza is to the west and the dolphin encosure is to the east.

You can see Shark tooth here.

* * *

>wear tank
You put on the scuba tank.

>s
You can't go that way.

>d
you jump into the water.

Pool
the water feels very warm up here, you see some fish down below. The bottom of the pool is below and the dolphin enclosure is up.

* * *

>x fish
beautiful colored fish swimming around.

>x fish
beautiful colored fish swimming around.

>s
You can't go that way.

>d
Bottom of Pool
 "blub blub" the water is very chilly down here "blub blub" you can see a fish next to "blub blub" a treasure chest.

>x treasure chest
a beautiful treasure chest layered in diamond with a tooth shaped lock.

>open chest
It seems to be locked.

>open chest with sharktooth
You unlock the treasure chest.

>open chest with shark tooth
That's unlocked at the moment.

>open treasure chest with shark tooth
That's unlocked at the moment.

>x chest
a beautiful treasure chest layered in diamond with a tooth shaped lock.

* * *

>open treasure chest
You open the treasure chest, revealing Meat.

>undo
Bottom of Pool
[Previous turn undone.]

>undo
Bottom of Pool
[Previous turn undone.]

>undo
Pool
[Previous turn undone.]

>d
Bottom of Pool
 "blub blub" the water is very chilly down here "blub blub" you can see a fish next to "blub blub" a treasure chest.

* * *

>x chest
a beautiful treasure chest layered in diamond with a tooth shaped lock.

>open ches
You can't see any such thing.

>open chest
It seems to be locked.

* * *

>open chest with shark tooth
That's unlocked at the moment.

>open chest
You open the treasure chest, revealing Meat.

>undo
Bottom of Pool
[Previous turn undone.]

>unlock chest
What do you want to unlock the treasure chest with?